................................................................................
................................................................................
................................................................................
................................................................................
................................................................................
................................................................................
................................................................................
........................#...#...................................................
................................................................................
................................................................................
.......................#######..................................................
................................................................................
##..................#...................#...................#.................X.
##################################...##########################.#.#.#.##########
##################################...##########################.#.#.#.##########
##################################...##########################.#.#.#.##########
##################################...##########################.#.#.#.##########
##################################...##########################.#.#.#.##########
##################################...##########################.#.#.#.##########
##################################...##########################.#.#.#.##########
##################################...##########################.#.#.#.##########
##################################...##########################.#.#.#.##########
##################################...##########################.#.#.#.##########
##################################...##########################.#.#.#.##########
##################################...##########################.#.#.#.##########
##################################...##########################.#.#.#.##########
##################################...##########################.#.#.#.##########
##################################...##########################.#.#.#.##########
##################################...##########################.#.#.#.##########
##################################...##########################.#.#.#.##########