...........................................................................8...
...........................................................................-.X.
...................................................................############
...............................................................................
..........................................................######...............
...............................................................................
................................................######.........................
...............................................................................
......................................######...................................
...............................................................................
............................######.............................................
...............................................................................
...................######......................................................
...............................................................................
............................######.............................................
...............................................................................
......................................######...................................
...............................................................................
................................................######.........................
...............................................................................
..........................................................######...............
...............................................................................
...................................................................######......
...............................................................................
..........................................................######...............
...............................................................................
................................................######.........................
...............................................................................
......................................######...................................
...............................................................................
............................######.............................................
...............................................................................
...............................................................................
###############################################################################
###############################################################################
###############################################################################
###############################################################################
###############################################################################
###############################################################################
###############################################################################