##########.....................................................................
##########.....................................................................
##########.....................................................................
##########.....................................................................
##########.....................................................................
##########.....................................................................
##########.....................................................................
##########.....................................................................
##########.....................................................................
##########.....................................................................
##########.....................................................................
##########.....................................................................
##########.....................................................................
##########.....................................................................
############...################################################################
###########...#################################################################
##########...##################################################################
#########...###################################################################
#########..####################################################################
#########.#####################################################################
#########.#####################################################################
#########...........................................................###########
#########...........................................................###########
#########...........................................................###########
#########.....-------------......----------.......-------------.....###########
#########...........................................................###########
#########...........................................................###########
#########.....-------------..#...----------...#...-------------.....###########
#########...........................................................###########
#########...........................................................###########
#########.....-------------..#...----------...#...-------------.....###########
#########...........................................................###########
#########...........................................................###########
#########.....-------------......----------.......-------------.....#...#######
#########...........................................................#.X.#######
#########...........................................................#.-.#######
###############################################################################
#######################################################################~#######
#########################################################################~#####
######################################################################~~###~###
########################################################################~######
#####################################################################~#~##~####
#######################################################################~#######
~~~~~~~~~~~~~~~~~~~~~~~~~~~~~~~~~~~~~~~~~~~~~~~~~~~~~~~~~~~~~~~~~~~~~~~~~~~~~~~
~~~~~~~~~~~~~~~~~~~~~~~~~~~~~~~~~~~~~~~~~~~~~~~~~~~~~~~~~~~~~~~~~~~~~~~~~~~~~~~
~~~~~~~~~~~~~~~~~~~~~~~~~~~~~~~~~~~~~~~~~~~~~~~~~~~~~~~~~~~~~~~~~~~~~~~~~~~~~~~
~~~~~~~~~~~~~~~~~~~~~~~~~~~~~~~~~~~~~~~~~~~~~~~~~~~~~~~~~~~~~~~~~~~~~~~~~~~~~~~
~~~~~~~~~~~~~~~~~~~~~~~~~~~~~~~~~~~~~~~~~~~~~~~~~~~~~~~~~~~~~~~~~~~~~~~~~~~~~~~
~~~~~~~~~~~~~~~~~~~~~~~~~~~~~~~~~~~~~~~~~~~~~~~~~~~~~~~~~~~~~~~~~~~~~~~~~~~~~~~
~~~~~~~~~~~~~~~~~~~~~~~~~~~~~~~~~~~~~~~~~~~~~~~~~~~~~~~~~~~~~~~~~~~~~~~~~~~~~~~
~~~~~~~~................................................................~~~~~~~
~~~~~~~~................................................................~~~~~~~
~~~~~~~~................................................................~~~~~~~
~~~~~~~~................................................................~~~~~~~
~~~~~~~~................................................................~~~~~~~
~~~~~~~~................................................................~~~~~~~
~~~~~~~~................................................................~~~~~~~
~~~~~~~~................................................................~~~~~~~
~~~~~~~~................................................................~~~~~~~
~~~~~~~~................................................................~~~~~~~
~~~~~~~~................................................................~~~~~~~
~~~~~~~~................................................................~~~~~~~
~~~~~~~~................................................................~~~~~~~
~~~~~~~~..............G.................................................~~~~~~~
~~~~~~~~~~~~~~~~~~~~~~~~~~~~~~~~~~~~~~~~~~~~~~~~~~~~~~~~~~~~~~~~~~~~~~~~~~~~~~~
~~~~~~~~~~~~~~~~~~~~~~~~~~~~~~~~~~~~~~~~~~~~~~~~~~~~~~~~~~~~~~~~~~~~~~~~~~~~~~~
~~~~~~~~~~~~~~~~~~~~~~~~~~~~~~~~~~~~~~~~~~~~~~~~~~~~~~~~~~~~~~~~~~~~~~~~~~~~~~~
~~~~~~~~~~~~~~~~~~~~~~~~~~~~~~~~~~~~~~~~~~~~~~~~~~~~~~~~~~~~~~~~~~~~~~~~~~~~~~~
~~~~~~~~~~~~~~~~~~~~~~~~~~~~~~~~~~~~~~~~~~~~~~~~~~~~~~~~~~~~~~~~~~~~~~~~~~~~~~~
~~~~~~~~~~~~~~~~~~~~~~~~~~~~~~~~~~~~~~~~~~~~~~~~~~~~~~~~~~~~~~~~~~~~~~~~~~~~~~~
~~~~~~~~~~~~~~~~~~~~~~~~~~~~~~~~~~~~~~~~~~~~~~~~~~~~~~~~~~~~~~~~~~~~~~~~~~~~~~~
~~~~~~~~~~~~~~~~~~~~~~~~~~~~~~~~~~~~~~~~~~~~~~~~~~~~~~~~~~~~~~~~~~~~~~~~~~~~~~~